0,0,0,0,0,0,s,s,s,s,s
0,r,r,r,r,r,0,0,0,0,0
r,r,0,0,0,r,0,0,0,0,0
0,0,r,r,r,r,0,0,0,0,0
0,0,r,0,0,0,0,0,0,0,0
0,0,r,r,r,r,r,r,r,0,0
s,0,s,s,s,s,0,0,r,0,0
0,s,0,0,0,0,s,0,r,0,0
